...................................
...................................
......###..###...##................
......#.#..##...#..................
......#.#..###...##................
...................................
...................................
......#.#.......##.................
......###...1...#.#................
......#.#.#####.##.................
...................................
...................................
......###..###..###...........X....
......#.#..##...###...........#....
......###..#....###................
...................................
...................................
...................................
...................................
